. . . . . . . . B . . . L L L . . . . . . . . . . . . . . . . .
. . . . . . . . B . . . L L L . . . . . . . . . . . . . . . . .
. . . . . . . . B . . . L L L . . . . . . . . . . . . . . . . .
. . . . . . . . B . . . L L L . . . . . . . . . . . . . . . . .
. . . . . . . . B . . . L L L . . . L L L . . . . . . . . . . .
. . . . . . . . B . . . L L L . . L L L . . . R R . . . . . . .
. . . . . . . . B . . . L L L L L L L L . . . R R . . . . . . .
. . . . . . . . B . . . L L L L L L . . . . . . . . . . . . . .
. . . . . . . . B . . . . . . . . . . . . R R . . . . . . . . .
. . . . . . . . B B . . . . . . . . . . . R R . . . . . . . . .
. . . . . . . . W B B . . . . . . . . . . . . . . . . . . . . .
. . . R R . . . W W B B B B B B B B B B . . . . . . . . . . . .
. . . R R . . . W W . . . . . . . . . B . . . . . . . . . . . .
. . . . . . . . W W . . . . . . . . . B . . . . . . T . . . . .
. . . W W W W W W W . . . . . . . . . B . . . . . . . . . . . .
. . . W W W W W W W . . . . . . . . . B . . R R . . . . . . . .
. . . W W . . . . . . . . . . B B B B B . . R R . W W W W W W W
. . . W W . . . . . . . . . . B . . . . . . . . . W . . . . . .
W W W W . . . . . . . . . . . B . . . W W W W W W W . . . . . .
. . . W W W W W W W . . . . . B . . . . . . . . . . . . B B B B
. . . W W W W W W W . . . . . B B B . . . . . . . . . . B . . .
. . . W W W W W W W . . . . . . . B W W W W W W B B B B B . . .
. . . W W W W W W W . . . . . . . B W W W W W W B . . . . . . .
. . . . . . . . . . . B B B . . . . . . . . . . B B . . . . . .
. . . . . R R . . . . B . . . . . . . . . . . . . B . . . . . .
. . . . . R R . . . . B . . . . . . . . . . . . . B . T . . . .
. . . . . . . . . . . B . . . . . R R . . . . . . B . . . . . .
. . . . . . . . . . . B . . . . . R R . . . . . . . . . . . . .
. . . . . . . . . . . B . . . . . . . . . . R R . . . . . . . .
. . . . . . . . . . . B . . . . . . . . . . R R . . . . . . . .
. . . . . . . . . . . B . . . . . . . . . . R R . . . . . . . .
. . . . . . . . . . . B . . . . . . . . . . R R . . . . . . . .
